+---+---+---+---+---+---+---+
| A |   |   |   | B |   |   |
+---+---+---+---+---+---+---+
| C |   |   |   |   |   |   |
+---+---+---+---+---+---+---+
| D |   | E |   |   |   |   |
+---+---+---+---+---+---+---+
|   |   |   |   |   | F | G |
+---+---+---+---+---+---+---+
|   |   |   |   |   |   | H |
+---+---+---+---+---+---+---+
|   |   |   | I |   | J |   |
+---+---+---+---+---+---+---+
|   | K |   |   | L |   |   |
+---+---+---+---+---+---+---+
|   |   |   |   |   |   |   |
+---+---+---+---+---+---+---+

L(6,4) -> B(0,4)

+---+---+---+---+---+---+---+
| A |   |   |   |   |   |   |
+---+---+---+---+---+---+---+
| C |   |   |   | L |   |   |
+---+---+---+---+---+---+---+
| D |   | E |   |   |   |   |
+---+---+---+---+---+---+---+
|   |   |   |   |   | F | G |
+---+---+---+---+---+---+---+
|   |   |   |   |   |   | H |
+---+---+---+---+---+---+---+
|   |   |   | I |   | J |   |
+---+---+---+---+---+---+---+
|   | K |   |   |   |   |   |
+---+---+---+---+---+---+---+
|   |   |   |   |   |   |   |
+---+---+---+---+---+---+---+

C(1,0) -> L(1,4)

+---+---+---+---+---+---+---+
| A |   |   |   |   |   |   |
+---+---+---+---+---+---+---+
|   |   |   | C |   |   |   |
+---+---+---+---+---+---+---+
| D |   | E |   |   |   |   |
+---+---+---+---+---+---+---+
|   |   |   |   |   | F | G |
+---+---+---+---+---+---+---+
|   |   |   |   |   |   | H |
+---+---+---+---+---+---+---+
|   |   |   | I |   | J |   |
+---+---+---+---+---+---+---+
|   | K |   |   |   |   |   |
+---+---+---+---+---+---+---+
|   |   |   |   |   |   |   |
+---+---+---+---+---+---+---+

A(0,0) -> D(2,0)

+---+---+---+---+---+---+---+
|   |   |   |   |   |   |   |
+---+---+---+---+---+---+---+
| A |   |   | C |   |   |   |
+---+---+---+---+---+---+---+
|   |   | E |   |   |   |   |
+---+---+---+---+---+---+---+
|   |   |   |   |   | F | G |
+---+---+---+---+---+---+---+
|   |   |   |   |   |   | H |
+---+---+---+---+---+---+---+
|   |   |   | I |   | J |   |
+---+---+---+---+---+---+---+
|   | K |   |   |   |   |   |
+---+---+---+---+---+---+---+
|   |   |   |   |   |   |   |
+---+---+---+---+---+---+---+

C(1,3) -> A(1,0)

+---+---+---+---+---+---+---+
|   |   |   |   |   |   |   |
+---+---+---+---+---+---+---+
|   | C |   |   |   |   |   |
+---+---+---+---+---+---+---+
|   |   | E |   |   |   |   |
+---+---+---+---+---+---+---+
|   |   |   |   |   | F | G |
+---+---+---+---+---+---+---+
|   |   |   |   |   |   | H |
+---+---+---+---+---+---+---+
|   |   |   | I |   | J |   |
+---+---+---+---+---+---+---+
|   | K |   |   |   |   |   |
+---+---+---+---+---+---+---+
|   |   |   |   |   |   |   |
+---+---+---+---+---+---+---+

C(1,1) -> K(6,1)

+---+---+---+---+---+---+---+
|   |   |   |   |   |   |   |
+---+---+---+---+---+---+---+
|   |   |   |   |   |   |   |
+---+---+---+---+---+---+---+
|   |   | E |   |   |   |   |
+---+---+---+---+---+---+---+
|   |   |   |   |   | F | G |
+---+---+---+---+---+---+---+
|   |   |   |   |   |   | H |
+---+---+---+---+---+---+---+
|   | C |   | I |   | J |   |
+---+---+---+---+---+---+---+
|   |   |   |   |   |   |   |
+---+---+---+---+---+---+---+
|   |   |   |   |   |   |   |
+---+---+---+---+---+---+---+

C(5,1) -> I(5,3)

+---+---+---+---+---+---+---+
|   |   |   |   |   |   |   |
+---+---+---+---+---+---+---+
|   |   |   |   |   |   |   |
+---+---+---+---+---+---+---+
|   |   | E |   |   |   |   |
+---+---+---+---+---+---+---+
|   |   |   |   |   | F | G |
+---+---+---+---+---+---+---+
|   |   |   |   |   |   | H |
+---+---+---+---+---+---+---+
|   |   | C |   | I |   |   |
+---+---+---+---+---+---+---+
|   |   |   |   |   |   |   |
+---+---+---+---+---+---+---+
|   |   |   |   |   |   |   |
+---+---+---+---+---+---+---+

C(5,2) -> E(2,2)

+---+---+---+---+---+---+---+
|   |   |   |   |   |   |   |
+---+---+---+---+---+---+---+
|   |   |   |   |   |   |   |
+---+---+---+---+---+---+---+
|   |   |   |   |   |   |   |
+---+---+---+---+---+---+---+
|   |   | C |   |   | F | G |
+---+---+---+---+---+---+---+
|   |   |   |   |   |   | H |
+---+---+---+---+---+---+---+
|   |   |   |   | I |   |   |
+---+---+---+---+---+---+---+
|   |   |   |   |   |   |   |
+---+---+---+---+---+---+---+
|   |   |   |   |   |   |   |
+---+---+---+---+---+---+---+

F(3,5) -> C(3,2)

+---+---+---+---+---+---+---+
|   |   |   |   |   |   |   |
+---+---+---+---+---+---+---+
|   |   |   |   |   |   |   |
+---+---+---+---+---+---+---+
|   |   |   |   |   |   |   |
+---+---+---+---+---+---+---+
|   |   |   | F |   |   | G |
+---+---+---+---+---+---+---+
|   |   |   |   |   |   | H |
+---+---+---+---+---+---+---+
|   |   |   |   | I |   |   |
+---+---+---+---+---+---+---+
|   |   |   |   |   |   |   |
+---+---+---+---+---+---+---+
|   |   |   |   |   |   |   |
+---+---+---+---+---+---+---+

G(3,6) -> F(3,3)

+---+---+---+---+---+---+---+
|   |   |   |   |   |   |   |
+---+---+---+---+---+---+---+
|   |   |   |   |   |   |   |
+---+---+---+---+---+---+---+
|   |   |   |   |   |   |   |
+---+---+---+---+---+---+---+
|   |   |   |   | G |   |   |
+---+---+---+---+---+---+---+
|   |   |   |   |   |   | H |
+---+---+---+---+---+---+---+
|   |   |   |   | I |   |   |
+---+---+---+---+---+---+---+
|   |   |   |   |   |   |   |
+---+---+---+---+---+---+---+
|   |   |   |   |   |   |   |
+---+---+---+---+---+---+---+

G(3,4) -> I(5,4)

+---+---+---+---+---+---+---+
|   |   |   |   |   |   |   |
+---+---+---+---+---+---+---+
|   |   |   |   |   |   |   |
+---+---+---+---+---+---+---+
|   |   |   |   |   |   |   |
+---+---+---+---+---+---+---+
|   |   |   |   |   |   |   |
+---+---+---+---+---+---+---+
|   |   |   |   | G |   | H |
+---+---+---+---+---+---+---+
|   |   |   |   |   |   |   |
+---+---+---+---+---+---+---+
|   |   |   |   |   |   |   |
+---+---+---+---+---+---+---+
|   |   |   |   |   |   |   |
+---+---+---+---+---+---+---+

G(4,4) -> H(4,6)

+---+---+---+---+---+---+---+
|   |   |   |   |   |   |   |
+---+---+---+---+---+---+---+
|   |   |   |   |   |   |   |
+---+---+---+---+---+---+---+
|   |   |   |   |   |   |   |
+---+---+---+---+---+---+---+
|   |   |   |   |   |   |   |
+---+---+---+---+---+---+---+
|   |   |   |   |   | G |   |
+---+---+---+---+---+---+---+
|   |   |   |   |   |   |   |
+---+---+---+---+---+---+---+
|   |   |   |   |   |   |   |
+---+---+---+---+---+---+---+
|   |   |   |   |   |   |   |
+---+---+---+---+---+---+---+

Edges discovered : 120616
Edges searched   : 120580
Solution depth   : 11
Backtrack depth  : 120569
